22222222111100000000111122222222
25111162111100000000111126111152
21111112111100000000111121111112
21111112111100000000111121111112
21111112111100000000111121111112
21111112111100000000111121111112
21111112111100000000111121111112
22211222111100000000111122211222
11111111111100000000111111111111
11111111111100000000111111111111
11111111111100000000111111111111
11111111111100000000111111111111
11111111111100000000111111111111
11111111111100000000111111111111
11111111111100000000111111111111
11111111111100000000111111111111
11111111111100000000111111111111
11111111111100000000111111111111
11111111111100000000111111111111
11114411111100000000111111441111
11114411111100000000111111441111
11111111111100000000111111111111
11111111111111111111111111111111
11111111111111111111111111111111
11111111111111111111111111111111
11111111111100000000111111111111
00000000000000000000000000000000
00000000000000000000000000000000
00000000000000000000000000000000
00000000000000000000000000000000
00000000000000000000000000000000
00000000000000000000000000000000
