22222222111100000000111122222222
27111152111100000000111125111182
291111121111000000001111211111A2
21111112111100000000111121111112
21111112111100000000111121111112
21111112111100000000111121111112
21111112111100000000111121111112
22211222111100000000111122211222
11111111111100000000111111111111
11111111111100000000111111111111
11111111111100000000111111111111
11111111111100000000111111111111
11111111111100000000111111111111
11111111116100000000161111111111
11111111111100000000111111111111
11111111111100000000111111111111
11111111111100000000111111111111
11111111131100000000113111111111
11111111111100000000111111111111
11111111111100000000111111111111
11114111111100000000111111141111
11111111111100000000111111111111
11111111111111111111111111111111
11311111111111111111111111111311
11111111111111111111111111111111
11111111111100000000111111111111
00000000000000000000000000000000
00000000000000000000000000000000
00000000000000000000000000000000
00000000000000000000000000000000
00000000000000000000000000000000
00000000000000000000000000000000
